DRDDLLLLLDLUURRRDRRRUULDRDLLLDLUULURDDDLDDRDDLUUUU
ULURDRUDDLDDRDRRULLDLUUUULURRDDLDDDDDLLULUURRRDRRU
LDLUUUURULDDDDDDDLLUULURRLDDDRRUUUUULURDRUDLDDLLDR
URRDDLUUUUUUDDDDDLLDRDRUUUUUUDDDRRRDDLDLRUULLDRURR
DRDLUUURDULLLLUUURRRRRRDDDRDLLLLLLDLUUUDRRRRDRRUUU
ULLLLLLLDRRURRRDRURDDDRDLLLLLLDLUUUDRRRRDRRUUUULLL
LLLLDRDDRDDDLLDLUUULURRDRUUULURRRRRDRURULDLLLLLDDD
DLLLLLURRRRDRUUULURRRRRDRRDDDLLLDLLDLUUUUUDDRRRRDR
RUUULLULLLLDDDRRRDDDRULUULLLUUURRRRDRRDDDLLLLLDLUU
UUDDRRRRDRRUUUULLLLRRRUULDRDLLRRRDDDDLLDDLLLLLDLUU
ULURRDRUU