DDDLLLLDDRRDDDRRUUUUDDDDLLUUULLUURRRRUUULLLDDUURRR
DDDDDDDDLLUUULLUURRRLLLDDRRDDDRRUUUUUUUDDLLLUUURRU
RRDLLRDDDDDDDRRRRRDRRULLLLLLDLUUUUUUDDDDDRRRRRRUUR
UULDDDULLULUURDDLDRRLUULLLLLRDDDDRRRRRDRRULLLLLLDL
UUUDDRRRRRRUUDDLLLLLDLLLUUULLUURRRRRRLLLLLLDDRRDDD
RRURRRRRRUULLUUULDRDDRRRUULDDDULLUULLLLLLLLDDRRDDD
RRUUUUDDDDLLUUULLUURRRRLLLUUURRURRDLLRDDDLLLLDDRRD
DDRRUUUUDDDDLLUUULLUURUUURRURDDULLDLLLURRRRURDLLDL
DDLDDRRDRLDDRRUUUDDRRRRRDRRULLLLLLDLUUDRRRRRRUULLL
URULRDDRRDDLLLLLLULLULULURRLLURUULLDRURDDLDR