UUUUUUUUURDRDRDRRURURURRLLDRURDLDULLDRLLLURRLURRRD
RDDDDDDUUUUUULULLDDRRURRDDLURULDLLLLDDRDRRRDRUUUUD
DDLLLDRDRUUUUURDDDDDDDLLUUULURRDRUUUDDDDLLDLUURURU
UULLLLDDRDRRRDRUUDLLLLUULURRRLLDDDRDDLUUUULURRLDDD
DLUUULURURDDDLDRRRRDRUDLLLLLLDRRRDRUULURDRUUDDDLLL
LDRRURRRDDLLULURRURDLLDLLDRRRLUULLLLLDRRRRDRULURRL
DLLLLDRRRRUUUULLUULLDDDDLDRRRRDRUULURRULLLUUUULLLU
RRRRLDDDDDDDDLLLLDRRRRRUUUULLLLDDRDDLLURRRRDRUUULU
RRRLLLUULLLDDDDRDDLLURRRRDRUUULURRDRULLLUUUULLLDDD
DDDRDDLLURRRRDRULURRULLLLLLDURUULDURUULDURUULDLLDD
DDRRRRRURDDDLDRRULLLLLURUUUUULLLDDDDRRRRRURDLDRRRU
LLUULLLLDURUULLLDDDDRRRRRRRRDDLDDLLLLLUUURUUUUULLL
DDDDRRRRRURDDLDRRUULUUUULLLLDDDUUULLDDDDRRRRRURDLD
RRULLLLLLLDRRRRRRDRULURLLLLLLLURRRRRURDDDDLDRUUUUL
LLLLLURRRRRDRULURDDDDLLLLLLDRRRRRDRUULURDDLLLLLLDR
RRRRDRULURDLLLLLLDRRRRRRUUUUUUUULLLLLLURRRRRRDLLLL
LDDDDLDRRRRRR