ULLLLRDDRD
DLUDDLLUUR
RDDDLDLUUR
RURRDDLLUL
LDDRURRRUU
URRDDRDLLL
UULLURURDL
LLLDDRDRUU
DLLUURRDRU
RRRDDDLLLR
RRUUULLLLD
DLDDLUURRU
URRRRDDDLL
LLUUURRRRU
ULUURDDDDD
DRDLUUUUUU
LLLLDDRDDL
UDDLLDDRUR
UUULLDDRDR
UUDLLUURRD
RURRRUUULL
LLLDLLURRR
RRRDRDDLLL
LLLDDRDDLU
URRUURRRRD
DDLLLLULLD
DRULUDRRUU
ULLDDRDRUU
DLLUURRRLL
LUURRURRRU
RDDDDDDUUU
UULLLLLDLD
DDDRDDLUUR
RUULLUULUR
RRRRRDRDDD
DRDLLLLLUL
LDDRURUUUL
LDDRDRUUDL
LUURRDDDLD
LUUUUUURRU
RRRURDDDDD
DRDLLLLLUL
LDDRULUUUU
ULURRRRRRU
RDDDDDDRDL
LLRRUUUUUU
LLLLLLDDDD
DRDRUUDLLU
UUUURRRRRR
DDDDDDLLLL
ULLDDRULUR
DRU