UUULULLDDRDDLLLUUUUUUURRRRRRRDRUDDDLUURULLLLLLLLLU
LDDDDUUURRRRRRRRRRDDDRDRRUUUUUUULLLDDDLLURDRUDLLLL
LLLDLDDDDDDRRRUULUURRUUDDLLDDRDDLLLUUUUUUURRRRRRUR
RDLLLLLLLLLULDDDRRDDDDDRRRUUULURDRUUUDDDLDDDLLLUUU
UUUURRRRRRURRDLLLLLLLLLULDDURRRRRRDDDDRDLUUUUULLLD
LDDDDDDRRRUUULURDRUUUDDDDLDDLLLUUUUUUURRRRRRURRDLL
LLLLLLULDDDDDRDLUUUUURRRRRDDRDULUURRRDDDLLULLDDRUU
UDRDRRUUULLLLLLLULDDDDDRDDDRRRUURRULUUUURRRDDDLLDL
UUUDRDRRUUULLLLLLLULDDDDRDDDDRRRUURRRRDRRULLLLLUUU
UULLLDLDDDDDDRRRUUULURDRUUUDRDRRUUULLLLLLLULDDDUUR
RRRRDDRDDDRRRRDRDLDLUURULLLLLUUUUULLLDLDDDDDDRRRUU
ULURDRUUUDRDRRUUULLLLLLLULDDURRRRRDDRDDDDRRURRDDLU
RULLLDLUULUUUURRRDDDLLDLUUUDRDRRUUULLLLLLLLULDRRRR
RRRRRDDRDRDDDRDLDLUURULLLDLUUDRRRRUULLLLDLUUUDRDRR
UUULLLLLLLDLURULRDRRRRRRRRDDLDLLDDRRRRUULLLLDLUUUD
RDRRUUULLLLLLLLRRRRRRRRRDDDRDRRUUUUUUULLLDDDDDLDLL
DDRRRRUULLLLDLUUUDRDRRUUULLLLLLDLLUURDDDDUUURRRRRR
RRDRDDDDDRDLDLUURULLLDLUUDRRRRUULLLLDLUUUDRDRRUUUL
LLLLLLDLURRRRRDDDDDLDDLLLUUUUUDDDDDRRRUUUUURUULLLD
LURRRRRRURRRDDDDDDDRDLDLUURULLLDLUUDRRRRUULLLLDLUU
UDRDRRUUULLLLLLL