LULUURULLLDLUURDDDDDLDDRUUUUUURULRDRDDDLRUULLDDDLD
DRUUUUULURDRUUDDLDDDDRULUUURRDDLDLUUULURDRURDDDRDD
LLDLUUUUDRRUULLULDRRRDDRDRRDLLLLDLUUUUUUUDRRDDDRDR
RURRDLLLDLLLUURRDRDLLLDLUUUUUURRDDDRDRDDDRRULDLURU
LLLLDLUUUUDRRUUULLLDRRRDDRDRRRRDRRDRRUURUULDLLLLDD
RULURDLLLLLULUUURRRURRDDDDRDLLLLDLLLUURRDRDLLLDLUU
UUDRRUUULLLDRRURDLLDDRRRDRRURDLLLULLLUUURRRRRURRDD
DDRDLLLLDLLLUURRDRDLLLDLUUUUDRRRDRRURRUUUULLDLLLLL
LDRDDRRRDRRRRRDRDRRUURUULDLLLDLLLLLULLLUUURRRRRURR
DDDDRDLLLLDLLLUURRDRDLLLDLUUUUUDDRRRDRRURRUUUULLDL
LLLLDDDRRUUDDRDRRURRUUUULLDLLLRRRURRDDDDRRRRUULLDU
RRDDLLLDLLLLLULUUURRRURRDDDDRDLLLLDLLLUURRDRDLLLDL
UUUUURLDDRRRDRRURRUUUULLDLLLDURRRURRDDDDRDDRULURUU
RRDDLLLDLLLLLULLLUURRURRRURRDDDDRDLLLLDLLLUURRDRDL
LLDLUUUUDRRRDRRURRUUUULLDLLLDLLRRURRDLLURRRURRDLLL
LRRRRDDDRRDDDRRUURULLLLDLUUULUURDDDDRDLLLLDLLLUURR
DRDLLLDLUUUUDRRRDRRRRRRDRDRUURULLLLDLUUULUURDDDDRD
LLLLDLLLUURRDRDLLLDLUUURRU