LDDDDLLUUUUULUURRRDRRRDDLRUULLLUURRDULLDLLLDDRDDDD
DRRURRUUURUULULLLLRRRRDRDDLDDDLLDLLUUUUULULLUURRDD
DDDRDLLRUULLDDLDDRUUUDRRUULLULDUURRRURRRDRULLLLDDR
DDDDDRRUUUURUULUURRDLLLLRRRDDDLDDDDLLUUUUULULLUURR
DDDRDLLLRRRDDDDRRUURUUUULUURRDLLLLRRRDDDDDDLDLLUUU
UULULLUURRDDDRDLLRDDLLUUUDRRUULLULDRRRURRRRDDDDRRU
UULRDDDLLUUURULLLLRRRDDDDDDLDLLUUUUULULLUURRDDDRDL
LRDDLLUUUULUURDLDRUURRDRRRRRDRDDLDLUUURULLLLRRRDDD
DDDLDLLUUUULLLUUUURRDDDRDLLRDDLLUUUUUDDDRRUUUULLUL
DDURRRDRRRRDDDDDDRUURULDLUUURULLLLRRRDDDDDDLDLLUUU
ULLLUUUURRDDDRDLLRDDLLUUUUUDDDRRUUUULLULDRRRDRRRRR
DRDDDRDLLDLUUUUURULLLLRRRDDDDDDLDLLUUUULLLUUUURRDD
DDDDUUUUURRRRRDRDRDRRULLDLLLUURRDRDLLDLUUURULLLLRR
RDDDDDDLDLLUUUULLLUUUURRDDDDUUURRRURRRRDDDRDLLLDLU
UURULLLLRRRDDDDDDLDLLUUUULLLUUUURRDDDRDLLRRDDLLLUU
UUUURRDRRRRRDRDDDDRULUURRDLLLDLUUURULLLLRRRDDDDDDL
DLLUUUULLLUUUURRDDDRDLLRUUUULLDDDDDDLDDRULURRLUURR
UUURRRRRDRRDRRDDLLLLDLUUUURULLLLRRRDDDDDDLDLLUUUUL
LLUUUURRDDDRDLLRUUUULLDDDDDDLDDRUUUURRRDDLLRRUULLL
DDLDDRUURRRUULDRDLLRRDDLUUURULLRUUUULLLUURDDRRDDL