RRRDDDLLLLLLULUURLDDRDRRURRRRUUUUULLDDRDRUDDDDLLLL
LLULUURUUURRDDRDRRURDDULLLULUULLDDDLDDRDRRRRRRRULL
LLRRRUUULLUURDLDDRRULRDDDDLLLLLLULUURUUURRDRRURRDD
DDUUUULLDLLULLDDDLDDRDRRRRRRRULLLRRUULLLULUULLDDRR
LLURDLDLDDRURUUDDLDDRRRRURRUULLLLRRRRDDDLLLLLLUURU
DLLURRRRRRURDDULLLLLDLDDRRRRRRRULLRUULLLLLLUUURRDD
UULLDDDDDDRRRRRURUULLLLLRUUULLDDDRRRRRURUULLDLRRUR
DDDDULLLLLLLDDRDRRRRRRRULUUUULLDRRDDDDLLLLLLULUURR
RRRRURDDDRDLLLLRRRUUULLLLURRRURDDDDRDLLLRRUUULLLLL
LUUURRDDUULLDDDRRRRRURDDDRDLLRUUULLLLLLURRRRRURDDD
DRDLUUUULLLLLLURRRRRURDDDDDUULLLLLLLDDRULURRRRRRUR
DD